*********XXXXXXXX*XXXXXXXXXXXXX
X*XXXXXXXX***************XXXXXX
X**********XXXXXXXXXXXXX*******
XXXXXXXXX*XXXX********XXXXXXXXX
XXXXXXXX*******XXXXXX**********