*XXXXXXXXXXXXXXXXXXXX
*XXXXXXXXXXXXXXXXXXXX
*XXXXXXXXXXXXXXXXXXXX
*XXXXXXXXXXXXXXXXXXXX
*XXXXXXXXXXXXXXXXXXXX
*XXXXXXXXXXXXXXXXXXXX
*XXX***XXXXXXXXXXXXXX
*XXX*X*XXXXXXXXXXXXXX
*****X*XXXXXXXXXXXXXX
XXXXXX*XXXXXXXXXXXXXX
*******XXXXXXXXXXXXXX
*XXXXXXXXXXXXXXXXXXXX
*XXXXXXXXXXXXXXXXXXXX
*XXXXXXXXXXXXXXXXXXXX
*XXXXXXXXXXXXXXXXXXXX
*XXXXXXXXXXXXXXXXXXXX
*XXXXXXXXXXXXXXXXXXXX
*XXXXXXXXXXXXXXXXXXXX
***XXXXXXX***XXXXX***
XX*XXXXXXX*X*XXXXX*X*
XX*********X*******X*