*******X*****X*******
*X*XXXXX*X*XXX*X*X*XX
*X*X*****X*****X*X***
XX*X*XXXXXXX*XXX*XXX*
***X***X***X***X***X*
*XXXXX*XXX*X*XXXXXXX*
*X*********X*X***X***
*X*XXXXX*XXX*X*X*X*X*
*X*X***X*X***X*X***X*
*X*X*X*X*XXXXX*X*XXX*
*X***X*X*X*****X***X*
*XXXXX*X*X*X*XXXXXXX*
*******X***X*****X***
*X*XXXXXXX*XXXXXXX*X*
*X*******X*******X*X*
*XXXXXXX*X*X*XXX*X*XX
*****X***X*X*****X***
*XXX*X*X*XXX*X*XXXXXX
*X***X*X*X***********
*X*XXX*X*X*XXXXXXXXXX
*X*****X*X***********
