****XXXXXXXXXXXXXXXXXXXXXXX*XXXXXXXXXXXX*****X
XXX**********************XX*XXXXXXXXXXXX*XXX*X
XXX*XXXXX*XXXXXXXXXXXXXXXXX******XXXXXX****X*X
XXX*XXXXX*XXXXXXXX**********XXXX********XXXX**
XXX*XXXXX**********XXXXXXXXXXXXX*XXXXXX*****X*
XXX*XXXXXXXXXXXXXXXXXXXXX********XXXXXXXXXX*X*