*****************X***
*X*X*XXXXX*X*X*X*X*X*
*X*X*X***X*X*X*X***X*
*X*X*X*X*XXX*X*XXXXX*
*X*X***X*****X***X*X*
*X*X*XXXXXXX*XXX*X*X*
*X*X*X*****X***X*****
*X*XXX*XXX*XXXXXXX*X*
*X*****X***X*****X*X*
*XXXXX*X*X*X*X*X*XXXX
*****X*X*X*X*X***X***
*X*X*X*X*XXX*X*X*X*X*
***X*X*X*****X*X***X*
*XXX*XXXXXXXXXXXXX*X*
*X*X***X*****X***X*X*
*X*XXX*X*X*X*X*X*XXX*
*X*X***X*X*X***X*****
*X*X*XXX*XXXXX*XXXXXX
*X*X***X*****X*X*****
*X*X*X*XXX*X*XXX*X*X*
***X*X***X*X*****X*X*
