****XXXXXXXXXXXXXXXXXXXXXXXXXXX
XXX****XXXXXXXXXXXXXXXXXXXXXXXX
XXXXXX****************XXXXXXXXX
XXXXXXXXXXXXXXXXXXXXX******XXXX
XXXXXXXXXXXXXXXXXXXXXXXXXX*****