*********XXXXXXXX*XXXXXXXXXXXXX
X*XXXXXXXX***************XXXXXX
X**********XXXXX*XXXXXXX*******
XXX*XXXXX*XXXX******XXXXXXXXXXX
XXX*XXXX*******XXXXXXXXXXXXXXXX
XXX*XXXXXXXXXXXXXXXXXXXXXXXXXXX
XXX****************************